150 150
10 10 90 90
12
 15 20 22 22 21 32 17 28
 14 38 20 37 21 49 16 48
 50 32 40 30 34 20 62 28
 26 35 30 23 37 33 32 40
 30 45 42 47 42 55 30 56
 44 40 44 35 53 36 53 41
 60 38 65 33 70 40 65 46
 50 54 50 50 67 54 59 61
 70 26 71 19 90 31 88 40
 15 70 18 54 23 53 24 70
 31 70 30 60 50 60 51 71
 65 70 72 55 85 55 80 69
